NO ./textures/BRICK_3D.xpm
SO ./textures/BRICK_3E.xpm
EA ./textures/Wood_Red.xpm
WE ./textures/Wood_Blue.xpm

F 255,204,153
C 0,51,102

1111111111111111111111111111111111111111111111111111111111111111
1111111111111011111111111111111101111111111111111111111111111111
11111111111110111111111111111111011111111111111111
11111111111100111111111111111111011111111111111111
10000000000000000000000000000000000000000000000001
10000000000000000000000000000000000000000000000001
10000000000000000000000000000000000000000000000001
10000000000000000000000000000000000000000000000001
1000000000000000000000000E000000000000000000000001
10000000000000000000000000000000000000000000000001
10000000000000000000000000000000000000000000000001
10000000000000000000000000000000000000000000000001
10000000000000000000000000000000000000000000000001
100000000000000000000000000000000000000000000000011111111111111111111111111111111111111111111111111111111111111111111111111111111111111111111111111111111111111111111111111111111111111111111111111111111111111111111111111111111111111111111111111111111111111111111111111111111111111111111111111111111111111111111111111111111111111111
111100000000000000000000000000000000000000000000000000000000000000000000000000000000000000000000000000000000000000000000000000000000000000000000000000000000000000000000000000000000000000000000000000000000000000000000000000000000000000000000000000000000000000000000000000000000000000000000000000000000000000000000000000000000000001
111100000000000000000000000000000000000000000000000000000000000000000000000000000000000000000000000000000000000000000000000000000000000000000000000000000000000000000000000000000000000000000000000000000000000000000000000000000000000000000000000000000000000000000000000000000000000000000000000000000000000000000000000000000000000001
111100000000000000000000000000000000000000000000000000000000000000000000000000000000000000000000000000000000000000000000000000000000000000000000000000000000000000000000000000000000000000000000000000000000000000000000000000000000000000000000000000000000000000000000000000000000000000000000000000000000000000000000000000000000000001
111100000000000000000000000000000000000000000000000000000000000000000000000000000000000000000000000000000000000000000000000000000000000000000000000000000000000000000000000000000000000000000000000000000000000000000000000000000000000000000000000000000000000000000000000000000000000000000000000000000000000000000000000000000000000001
111100000000000000000000000000000000000000000000000000000000000000000000000000000000000000000000000000000000000000000000000000000000000000000000000000000000000000000000000000000000000000000000000000000000000000000000000000000000000000000000000000000000000000000000000000000000000000000000000000000000000000000000000000000000000001
111100000000000000000000000000000000000000000000000000000000000000000000000000000000000000000000000000000000000000000000000000000000000000000000000000000000000000000000000000000000000000000000000000000000000000000000000000000000000000000000000000000000000000000000000000000000000000000000000000000000000000000000000000000000000001
111100000000000000000000000000000000000000000000000000000000000000000000000000000000000000000000000000000000000000000000000000000000000000000000000000000000000000000000000000000000000000000000000000000000000000000000000000000000000000000000000000000000000000000000000000000000000000000000000000000000000000000000000000000000000001
111100000000000000000000000000000000000000000000000000000000000000000000000000000000000000000000000000000000000000000000000000000000000000000000000000000000000000000000000000000000000000000000000000000000000000000000000000000000000000000000000000000000000000000000000000000000000000000000000000000000000000000000000000000000000001
111100000000000000000000000000000000000000000000000000000000000000000000000000000000000000000000000000000000000000000000000000000000000000000000000000000000000000000000000000000000000000000000000000000000000000000000000000000000000000000000000000000000000000000000000000000000000000000000000000000000000000000000000000000000000001
111100000000000000000000000000000000000000000000000000000000000000000000000000000000000000000000000000000000000000000000000000000000000000000000000000000000000000000000000000000000000000000000000000000000000000000000000000000000000000000000000000000000000000000000000000000000000000000000000000000000000000000000000000000000000001
111100000000000000000000000000000000000000000000000000000000000000000000000000000000000000000000000000000000000000000000000000000000000000000000000000000000000000000000000000000000000000000000000000000000000000000000000000000000000000000000000000000000000000000000000000000000000000000000000000000000000000000000000000000000000001
111100000000000000000000000000000000000000000000000000000000000000000000000000000000000000000000000000000000000000000000000000000000000000000000000000000000000000000000000000000000000000000000000000000000000000000000000000000000000000000000000000000000000000000000000000000000000000000000000000000000000000000000000000000000000001
111100000000000000000000000000000000000000000000000000000000000000000000000000000000000000000000000000000000000000000000000000000000000000000000000000000000000000000000000000000000000000000000000000000000000000000000000000000000000000000000000000000000000000000000000000000000000000000000000000000000000000000000000000000000000001
100000000000000000000000000000000000000000000000011111111111111111111111111111111111111111111111111111111111111111111111111111111111111111111111111111111111111111111111111111111111111111111111111111111111111111111111111111111111111111111111111111111111111111111111111111111111111111111111111111111111111111111111111111111111111111
111100000000000000000000000000000000000000000000000000000000000000000000000000000000000000000000000000000000000000000000000000000000001
111100000000000000000000000000000000000000000000000000000000000000000000000000000000000000000000000000000000000000000000000000000000001
111100000000000000000000000000000000000000000000000000000000000000000000000000000000000000000000000000000000000000000000000000000000001
10000000000000000000000000000000000000000000000111111111111111111111111111111111111111111111111111111111111111111111111111111111111111
1111111111111111111111100111111111111111111111111111111111111111
1111111111111111111111100111111111111111111111111111111111111111
1111111111111111111111100111111111111111111111111111111111111111
1111111111111111111111100111111111111111111111111111111111111111
1111111111111111111111100111111111111111111111111111111111111111
111111111111111111111110011111111111111111  11111111111111111111
1111111111111111111111100111111111111111111111111111111111111111
1111111111111111111111100111111111111111111111111111111111111111
1111111111111111111111100111111111111111111111111111111111111111
1111111111111111111111100111111111111111111111111111111111111111
1111111111111111111111100111111111  1111111111111111111
1111111111111111111111100111111111111111111111111111111111111111
1111111111111111111111100111111111111111111111111111111111111111
1111111111111111111111100111111111111111111111111111111111111111
1111111111111111111111100111111111111111111111111111111111111111
1111111111111111111111100111111111111111111111110000111111
1111111111111111111111100111111111111111111111111111111111111111
1111111111111111111111100111111111111111111111111111111111111111
1111111111111111111111100111111111111111111111111111111111111111
1111111111111111111111100111111111111111111111111111111111111111
1111111111111111111111100111111111     1111111111111111111111111
1111111111111111111111100111111111111111111111111111111111111111
1111111111111111111111100111111111111111111111111111111111111111
1111111111111111111111100111111111111111111111111111111111111111
1111111111111111111111100111111111111111111111111111111111111111
11111111111111111111111001111111111111111111111111111111111
1111111111111111111111100111111111111111111111111111111111111111
1111111111111111111111100111111111111111111111111111111111111111
1111111111111111111111100111111111111111111111111111111111111111
1111111111111111111111100111111111111111111111111111111111111111
1111111111111111111111100111111111111111111111111111111111111111
1111111111111111111111100111111111111111111111111111111111111111
1111111111111111111111100111111111111111111111111111111111111111
1111111111111111111111100111111111111111111111111111111111111111
1111111111111111111111100111111111111111111111111111111111111111
1111111111111111111111100111111111111111111111111111111111111111
1111111111111111111111100111111111111111111111111111111111111111
1111111111111111111111100111111111111111111111111111111111111111
1111111111111111111111100111111111111111111111111111111111111111
1111111111111111111111100111111111111111111111111111111111111111
1111111111111111111111100111111111111111111111111111111111111111
1111111111111111111111100111111111111111111111111111111111111111
1111111111111111111111100111111111111111111111111111111111111111
1111111111111111111111100111111111111111111111111111111111111111
1111111111111111111111100111111111111111111111111111111111111111
1111111111111111111111100111111111111111111111111111111111111111
1111111111111111111111100111111111111111111111111111111111111111
1111111111111111111111100111111111111111111111111111111111111111
1111111111111111111111100111111111111111111111111111111111111111
1111111111111111111111100111111111111111111111111111111111111111
1111111111111111111111100111111111111111111111111111111111111111
1111111111111111111111100111111111111111111111111111111111111111
1111111111111111111111100111111111111111111111111111111111111111
1111111111111111111111100111111111111111111111111111111111111111
1111111111111111111111100111111111111111111111111111111111111111
1111111111111111111111100111111111111111111111111111111111111111
1111111111111111111111100111111111111111111111111111111111111111
1111111111111111111111100111111111111111111111111111111111111111
1111111111111111111111100111111111111111111111111111111111111111
1111111111111111111111100111111111111111111111111111111111111111
1111111111111111111111100111111111111111111111111111111111111111
1111111111111111111111100111111111111111111111111111111111111111
1111111111111111111111100111111111111111111111111111111111111111
1111111111111111111111100111111111111111111111111111111111111111
1111111111111111111111100111111111111111111111111111111111111111
1111111111111111111111100111111111111111111111111111111111111111
1111111111111111111111100111111111111111111111111111111111111111
1111111111111111111111100111111111111111111111111111111111111111
1111111111111111111111100111111111111111111111111111111111111111
1111111111111111111111100111111111111111111111111111111111111111
1111111111111111111111100111111111111111111111111111111111111111
1111111111111111111111100111111111111111111111111111111111111111
1111111111111111111111100111111111111111111111111111111111111111
1111111111111111111111100111111111111111111111111111111111111111
1111111111111111111111100111111111111111111111111111111111111111
1111111111111111111111100111111111111111111111111111111111111111
1111111111111111111111100111111111111111111111111111111111111111
1111111111111111111111100111111111111111111111111111111111111111
1111111111111111111111100111111111111111111111111111111111111111
1111111111111111111111100111111111111111111111111111111111111111
1111111111111111111111100111111111111111111111111111111111111111
1111111111111111111111100111111111111111111111111111111111111111
1111111111111111111111100111111111111111111111111111111111111111
1111111111111111111111100111111111111111111111111111111111111111
1111111111111111111111100111111111111111111111111111111111111111
1111111111111111111111100111111111111111111111111111111111111111
1111111111111111111111100111111111111111111111111111111111111111
1111111111111111111111100111111111111111111111111111111111111111
1111111111111111111111100111111111111111111111111111111111111111
1111111111111111111111100111111111111111111111111111111111111111
1111111111111111111111100111111111111111111111111111111111111111
1111111111111111111111100111111111111111111111111111111111111111
1111111111111111111111100111111111111111111111111111111111111111
1111111111111111111111100111111111111111111111111111111111111111
1111111111111111111111100111111111111111111111111111111111111111
1111111111111111111111100111111111111111111111111111111111111111
1111111111111111111111100111111111111111111111111111111111111111
1111111111111111111111100111111111111111111111111111111111111111
1111111111111111111111100111111111111111111111111111111111111111
1111111111111111111111100111111111111111111111111111111111111111
1111111111111111111111100111111111111111111111111111111111111111
1111111111111111111111100111111111111111111111111111111111111111
1111111111111111111111100111111111111111111111111111111111111111
1111111111111111111111100111111111111111111111111111111111111111
1111111111111111111111100111111111111111111111111111111111111111
1111111111111111111111100111111111111111111111111111111111111111
1111111111111111111111100111111111111111111111111111111111111111
1111111111111111111111100111111111111111111111111111111111111111
1111111111111111111111100111111111111111111111111111111111111111
1111111111111111111111100111111111111111111111111111111111111111
1111111111111111111111100111111111111111111111111111111111111111
1111111111111111111111100111111111111111111111111111111111111111
1111111111111111111111100111111111111111111111111111111111111111
1111111111111111111111100111111111111111111111111111111111111111
1111111111111111111111100111111111111111111111111111111111111111
1111111111111111111111111111111111111111111111111111111111111111
