NO ./textures/babyfoot.xpm
SO ./textures/deadpool_chicken.xpm
WE ./textures/pb_texture.xpm
EA ./textures/elden_ring.xpm

F 255,0,150
C 25,90,100

111111
100101
101001
1100N1
111111
