NO ./textures/loz_tears_kingdom.xpm
SO ./textures/piplup.xpm
WE ./textures/begin_raycasting.xpm
EA ./textures/horror_minishell.xpm

F 100,125,21
C 245,74,0

        1111111111111111111111111
        1000000000110000000000001
        10110000011100000000W0001
        1001000000000000000000001
111111111011000001110000000000001
100000000011000001110111111111111
11110111111111011100000010001
11110111111111011101010010001
11000000110101011100000100001
10000000000100001100000100001
10000000000000001101011010001
1100000111010101111101111000111
11110111 1110101 101111110001
11111111 1111111 111111111111
