NO ./textures/loz_tears_kingdom.xpm
SO ./textures/piplup.xpm
WE ./textures/begin_raycasting.xpm
EA ./textures/horror_minishell.xpm

F 177,156,217
C 251,197,180

11111111
10100001
10100001
1010N001
10000001
10000101
10000001
11111111
