NO ./textures/debug_north.xpm
SO ./textures/debug_south.xpm
WE ./textures/debug_west.xpm
EA ./textures/debug_east.xpm

F 100,200,50
C 225,199,07


11111111111111111111111111
10000000000000000000000001
10000000000000000000000001
11111111111000001111111111
10000000000000000000000001
10000000000000000000000N01
10000000000000000000000001
10000000000000000000000001
10000000000000000000000001
10000000000000000000000001
11111111111111111111111111

