NO ./textures/BRICK_3D.xpm
SO ./textures/BRICK_3D.xpm
WE ./textures/BRICK_3D.xpm
EA ./textures/BRICK_3D.xpm

F 100,125,21
C 245,74,0

        1111111111111111111111111
        1000000000110000000000001
        1011000001110000000000001
        100100000000000000S000001
111111111011000001110000000000001
100000000011000001110111111111111
11110111111111011100000010001
11110111111111011101010010001
11000000110101011100000100001
10000000000100001100000100001
10000000000000001101010100001
110000011101010111110111000111
11110111 1110101 1011110001
11111111 1111111 111111111111
