NO ./textures/BRICK_3D.xpm
SO ./textures/BRICK_3E.xpm
WE ./textures/Wood_Blue.xpm
EA ./textures/Wood_Red.xpm

F 100,125,21
C 245,74,0

        1111111111111111111111111
        1000000000110000000000001
        1011000001110000000000001
        10010000000000000000N0001
111111111011000001110000000000001
100000000011000001110111111111111
11110111111111011100000010001
11110111111111011101010010001
11000000110101011100000110001
10000000000100001100000110001
10000000000000001101010110001
1100000111010101111101111000111
11110111 1110101 101111110001
11111111 1111111 111111111111
