NO ./textures/debug_north.xpm
SO ./textures/debug_south.xpm
WE ./textures/debug_west.xpm
EA ./textures/debug_east.xpm

F 100,200,50
C 225,199,07

        1111111111111111111111111
        1000000000110000000000001
        1011000001110E00000000001
        1001000000000000000000001
111111111011000001110000000000001
100000000011000001110111111111111
11110111111111011100000010001
11110111111111011101010010001
11000000110101011100000100001
10000000000000001100000100001
1000000000000000110101010001
110000011101010111110111000111
11110111 1110101 1011110001
11111111 1111111 111111111111
