NO ./textures/BRICK_3E.xpm
SO ./textures/BRICK_3E.xpm
WE ./textures/BRICK_3D.xpm
EA ./textures/BRICK_3D.xpm

F 220,200,50
C 225,230,07

        1111111111111111111111111
        1000000000110000000000001
        1011000001110000000000001
        1001000000000000000000001
111111111011000001110000000000001
100000000011000001110111111111111
111101111111110111000000110001
111101111111110111010100110001
11000000110101011100000010N01
10000000000000001100000010001
10000000000000001101010010001
1100000111010101111101111000111
11110111 1110101 101111010001
11111111 1111111 111111111111
