

F 220,200,50
C 225,230,07
NO ./textures/BRICK_3E.xpm
SO ./textures/BRICK_3E.xpm
WE ./textures/BRICK_3D.xpm
EA ./textures/BRICK_3D.xpm

111
1
11


1111
1101
1111


1111111111111111111111111111111
100000000000000000000000000001
111111111111111111111111111111111
        1111111111111111 1111111
        1000000000110001 10000001
        1011000001110000100000001
        1001000000000000000000001
111111111011000001110000000000001
100000000011000001110111111111111
11110111111111011100000010001
1111011111111111101010010001
1000000111111110101110000001
1111111111111111111111111111
1
1
1111111111111111111111111111
1000000111111111111000000011
1000000000000001101010010001
11000001110101011111011110N01
11110111 1110101 101111010001
11111111 1111111 111111111111
1
1
1
1          1111111111111111111
1111111111111000000000000001
111111111111111111111111111111


