NO ./textures/BRICK_3E.xpm
SO ./textures/BRICK_3E.xpm
WE ./textures/BRICK_3D.xpm
EA ./textures/BRICK_3D.xpm

F 220,100,50
C 225,30,0

        1111111111111111111111111
        1000000000110000000000001
        101100E001110000000000001
        1011000011100E00000000011001000000000000000000001
111111111011000001110000000000001
100000000011000001110111111111111
11110111111111011100000010S01
11110111111111011101010010001
11000000110101011100000010001
10000000000000001100000010001
10000000000000001101010010001
11000001110101011111011110111
11110111 1110101 101111010001
11111111 1111111 111111111111
